W##############################
#A        #    B    #        C#
#.####### #  ....   # # *   * #
#\        #  .      # #*******#
# #######.#  .      # #*******#
#         #    W  . # #***\***#
#.####### #  .  # . # #*******#
#         #  .#*# . # #*******#
# #######.##  #*#  ## ........#
#        .*#  #\.  #*.        #
######### \####.####\ #########
#       ##  #1#  3#  #    *   #
#   @ @  ##    #    #  @ #*#  #
#  .. .. ##    2    #\ # #*#  #
#   @ @  #*#       #*# # #*#  #
#D .. .. #*#4  L  5#*#   #*\#E#
#   @ @ # @ #  R  # @ #  #*#  #
#  .. ..  #         #    #*#  #
#        #*# 6   8 #*#   #*#  #
#        #*.   7   .*##   \   #
######### @ # **### @ #########
#\     #I ### ..@ ### \\ \\\  #
# # ## ####@#####   #  \*\ \* #
# #  #\  9#*   G ## #  \\\ \\\#
# # .# ## #***    # #       *\#
# # .\ ## #****  *# #  \\\ \\\#
#   ..  . #*******# #  \ \*\  #
#  #\ ##..#*#*#*#*#.#  \ \\\  #
# ###  ##.#. . . .  # \\      #
#F     \  #         #        H#
##############################W

Trampoline A targets 1
Trampoline B targets 2
Trampoline C targets 3
Trampoline D targets 4
Trampoline E targets 5
Trampoline F targets 6
Trampoline G targets 7
Trampoline H targets 8
Trampoline I targets 9
Growth 2
Razors 4
Water 0
Waterproof 60
Flooding 40
Author bhickey (https://gist.github.com/3118575)