######
#. *R#
#  \.#
#\ * #
L  .\#
######

Highscore 212
