#############################
#..........................\#
#..\\###...#....        ###.#
#..\*\\\.. #.... ..##\\..\#.#
#..\*\.... #.... ..#\#....#.#
#...\###.. #.... ....#....#.#
#... ..... ..... .####......#
#\\. #....           .......#
#... #..#. .....*\ ##.......#
#.#....... ...#..  ....######
#. ...#... ...#.\  ....#..* #
##........ ...#.. #....#.#\\#
#.....*... .....*\#\\.....*.#
#.***.* .......*\****.....#.#
#.\\\.. ................   .#
#.#####    .######    ##### #
#....\\.................... #
#....****...#.##.....\\\\..\#
#....\\\\...#.........*....\#
#....\\\\...#.\\.    #\###.\#
#....     ..#.... ...#\\\\. #
#........ ..#.... ...#..... #
#........         ........#R#
###########################L#

Highscore 3634
