#######
#..***#
#..\\\#
#...**#
#.*.*\#
LR....#
#######

Highscore 281
