###################
#*************   ##
##***********# * ##
###*********##.*.##
####*******####*###
#####*****#####*###
######***######*###
#######*#######*###
###### * ######*###
#\     .      #*###
#\     \      #*###
#\     **     #*###
#\     ##     #*###
#\            #*###
#\    \  \    #*###
#\    ** **   #*###
#\    ## ##   #*###
#\            #*###
#\   \  \  \  #*###
#R   ** ** ** #*\##
#### ## ## ## #*###
###L           . ##
#### ## ## ## ##  #
###  #  ##  #  #  #
###  #  ##  #  #  #
###  #  ##  #  #  #
###################

Author ems_ (irc)
Highscore 990
