#############################
#.......*..........  ....\\.#
#......###........  W\\\....#
#..   ..............#.......#
#.....##########.\\\#.####..#
#..*...........#....#..\\.\.#
#.*\\.....\.. .##########\..#
# @ *. .\.... .#....#...\\..#
# ###. ....\. ......#....\..#
# #... ..\\\\\\\\\..###.....#
# #... .          .#....##..#
# #... ..#. .......#.\\\\\..#
# ##.. ..#. .####..#..\.....#
#.\#.. ..# ........#....#####
#..#.. ... ........#.\\\..  L
####.. ... ....#.....W\     #
#......... ....#........... #
#....#####.....###########. #
#..............#......#.....#
#..\#.\.....#######...#.....#
#..\#.......#.........#.....#
#...........#.\\\\\...#.....#
#...####....#.........#.....#
#.\..\.#.. .#...#####.#.....#
#..#...#....#..*............#
#..#.....\..#...............#
##\\\\### #####.######......#
#........!!R.....\\..#......#
#############################

Water 2
Flooding 40
Waterproof 10 
Highscore 2601
