############
#.....*....#
#..... ....#
#..\\\ \\..#
#.     ....#
#..\\\ \\\.#
#..\..    .#
#..\.. ....#
#.....  .\ #
#.....  .\ #
#...@.  .*\#
#....@  .*\#
#..### ### #
#...R#\#\\.#
######L#####

Highscore 1589
