###############################################################I################
#                                                             #*** \\ #W      W#
#                      ###############                        #\\\ .. #W      W#
#                      #\\\.......** ######           #########.##    ##########
#                      #\\#.#####...##. *7#           #.......\ ..........*   .#
#                      #\\#.....*##. #  \.#           #*******\......#....#\\ .#
#                      #\#####\...## #\ * #           ###\.\\\...**..#....... *#
#         W            #\......####* H  .\#           #*****\\  .\\..##     #\.#
#                      #\.######* #.\#########        ######### ....  ##########
#                      #\.#. *...##.## ##    *#               #       #        #
#                      #\##. ..  *...#  ##6 .*##              ####*####   WW   #
#                      #\...... F#.#.#   ##\\\\##             #.......#        #
#                      ###########.#.# W  ##....##    #########  \\\\*##########
#           ############\..........#.#   ##..\ . ##   #*\\  **#     *..*\ \\\\\#
#           #..........##.##########.#  ## . G .  ##  #.\**\*** .....**.# \\##\#
#           #.....*....#5.#\.........# ##\\\# #\\\\## #\8......     .\\.. \\\\\#                                                   
#           #..\\\\\\..######################  #################################                            
#           #.     ....#.*..#\.#\\... ......#      #..........................\#                            
#           #..\\\\\\\.#.\..#\.D##.#. ...*..#      #..\\###...#....        ###.#                            
#           #..\..    .#.3 .##.# #.#. ... ..#      #..\*\\\.. #.... ..##\\..\#.#                            
#           #..\.. ....#.\  ...### #.   \ ..#      #..\*\.... #.... ..#\#....#.#                            
#           #..... ..* #..\  ..#. .#..... **########...\###.. #.... ....#....#.#                            
#           #..### ### #...\  ##.#\#..... ..\\\*.  #... ..... ..... .####......#
#           #...4#\#\\.#....\ \#*\\#.###. ####\\\  #\\. #....           .......#
#           ######E#############\\.#.     ...## \  #... #..#. .....*\ ##.......#
#                             W#\#.#..... ....# \  #.#....... ...#..  ....######
#                 ################.#..... ....#    #. ...#... ...#.\  ....#..* #
#                 #..2...#..***#\\.#..... ....#\   #......... ...#.. #....#.#\\#
#                 #..*...#..\\\########.. ..###*####.....*... .....*\#\\.....*.#
#                 #..#...#...**#......... .........#.***.* .......*\****.....#.#
#       W         #.\.\..C.*.*\#......... ....***..#.\\\.. ................   .#
#                 ####**.B1....#..\\\\\ # ####.....#.#####    .######    ##### #
#                 #\.....#######........*R..\\\   .#....\\.................... #
#                 #\..* .#     ##########A##########....****...#.##.....\\\\..\#
#                 ########                         #....\\\\...#.........*....\#
#                                                  #....\\\\...#.\\.    #\###.\# 
#                                        W         #....     ..#.... ...#\\\\. # 
#                                                  #........ ..#.... ...#..... # 
#                                                  #........         ........#9# 
##############################################################################L# 

Trampoline A targets 1
Trampoline B targets 2
Trampoline C targets 3
Trampoline D targets 4
Trampoline E targets 5
Trampoline F targets 6
Trampoline G targets 7
Trampoline H targets 8
Trampoline I targets 9
Growth 1
Highscore 5749
