    #######
    ##*   @#
     #\R .*##
      ##\\\\##
       ##....##
      ##@.\ @ ##
     ##*. L .  ##
    ##\\\# #\\\\##
   ######   #######

Highscore 1163
