#################
#A       .@@@@@@#
#  ..    #*...*1#
#  .##########*##
#  ..@   \\\\#* #
#  ..#   #####*.#
#   .#####    * #
#LR .......   . #
#################

Trampoline A targets 1
Flooding 10
Water 0
Highscore 747
