#################
# \\\\#   *  *  #
#  ##   !!#..@. ####
#*    @...####.....#
#\\   \@...........#
#\  # .\@    #  #.########
#\  # ..\@   #   ..      #
#\  # .. \@  #   ..      #
#\  # *.. \@    #######  #
#\  # ###  \@   #     #W #
### #       \@  #     ##L#
#...#@@**@@**\@ #
#R ..........!\##
#################

Growth 25
Highscore 2406
