###############
#\\\.......** #
#\\#.#####...##
#\\#.....*##. #
#\#####\...## #
#\......####* #
#\.######* #.\#
#\.#. *...##.##
#\##. ..  *...#
#\...... L#.#.#
###########.#.#
#\..........#.#
##.##########.#
#R.#\.........#
###############

Highscore 1177
Comment Same as contest6
