####################
#    #         \..\#
#\#\  \#....#   ####
#.#  # .....#   \\ #
#.#  #  ....#  *   #
#.#  #R     #  \.  #
#.#  #****. # ..\  #
#.#  #*****\# ..#  #
#\#  #\....\#  \#  #
#\   #..#..\#      #
#\#### ########### #
#... #   #  ..\\\\ #
# .. #   #  \###.. #
# ...... #         #
# ###### #   ***** #
# ...... #**.\\\.. #
# \  #.. #\\...... #
# .. #   #     \\\ #
#    \\\\#L *...   #
####################

Highscore 2486
