     ######
     #....#############
     #.**.. .. ..** \\#
     #.**..  .  ..\ \\#
     #.**..  .    .   #
######.\\......#****###
#**....*.......# .. #
#\\...\L\\\....#    #
#\......\*\**..# .\\#
######R.....###########
     ###.**. * ....\\\#
       #\\\\#..\\\.\\\#
       #\\\\#......\\\#
       ################

Water 2
Flooding 20
Highscore 1541
