#######     #######
#..**.#     #..*\*#
#.R*\\#######.****#
# \\    ..... \*\*#
#  \\\\\  ...\\\*\#
#..........\...\.\#
######..**. #######
     #.##\..#
     #.#.##.#
     # \\...#
###### .#.**#######
#      ...\\\\\\\.#
# ................#
#..**........*.*.\#
#\\#. #######\#\.\#
#\\#\ #     # ... #
#######     #L#####

Highscore 1634
