########################
#.....................\#
#......*\   ...........#
#......*... ......* ...#
#..   \\... .*..... ...#
#.. ....... ....... ...#
#.. ....... .\\.... ...#   ######
#.  ....      .....\...#   #\\\\#
#\\\......... .........#   #....#
###########     R      ########*#####
          #.......... ........***\\\#
          #.......... ............**#
          #.......... ......... *.*\#
          #....\\.... ....\\..... ..L
          #.....................****#
          #........\*...............#
          #...........     .........#
          #.........................#
          ###########################

Water 1
Flooding 20
Waterproof 10
Highscore 1594
Comment Same as flood4
