###########################
#............#............#
#.####.#####.#.#####.####.#
#\#  #.#   #.#.#   #.#  #\#
#.####.#####.#.#####.####.#
#.........................#
#.####.#.#########.#.####.#
#......#.....#.....#......#
######.#####.#.#####.######
     #.#           #.#
######.# #### #### #.######
L     .  #       #  .    **
######.# ######### #.######
     #.#           #.#
######.# ######### #.######
#............#............#
#.####.#####.#.#####.####.#
#\...#.      R      .#...\#
####.#.#.#########.#.#.####
#......#.....#.....#......#
#.##########.#.##########.#
#.........................#
###########################

Author newsham (www.thenewsh.com/~newsham/x/pacman.map)
Highscore 191
