    #############################
    #***************************#
    #                           #
    #                           #
    #                           #
    #                           #
    #                           #
    #                           #
    #                           #
    #R\\\\\\\\\\\\\\\\\\\\\\\\\\L
    #############################

!RRRRRRA
294
Aborted