############
#..*.R..*..#
#..A....B..######
#....2.. ..#\\\C#
#......* *.#\\\1#
########L########

Trampoline A targets 1
Trampoline B targets 1
Trampoline C targets 2
Highscore 426
